suffering - страдание
inspiration - вдохновение
argue - спорить
jug - кувшин
bench - скамейка
brazier - мангал
tray - поднос
belongings - пренадлежности
grater - терка
tearful - плачущий
pour - наливать, выливать, поливать
pull - тянуть
slip - проскальзывать, выскальзывать
 patiently - терпеливо, спокойно
quarter - четвертак
annoy - раздраженный
grow - растет, рост
coincidence - совпадение
reply - ответить
furiou - взбеситься
selfish- эгоистичный
offen - обидеть
spic and span - безупречно чистый
stumbles - вспотыкаясь
stuck - застрять

vomit- блевать
irritation - раздражение
genuinely - искренне
saucepan - кастрюля
tray - поднос
meaningful - осмысленно
funeral - похороны
appreciate - оценивать
procrastinate - откладывать
parcel- посылка




add new text
